NO ./textures/sassocarta.xpm
EA ./textures/sassocarta.xpm
SO ./textures/sassocarta.xpm
WE ./textures/sassocarta.xpm

F 36,28,24
C 25,100,100

1111111111111111111
1FFFFFFFFFFFFFFFFF1
1FFFFFFFFFFFFFFFFF1
1FFFFFFFFFFFFFFFF11
1FFFFFFFFFFFFFFFFF1
1FFFFFFFFFFFFFFFFF1
1FFFFFFFFFFFFN11F11
111111111D111111111
111111FFFFFFFFD1111
11111DFFFFFCFFFFFF1
1FFFFFFFFFFFF1D1FF1
1111111111111111111